##############
#            #
##### ########
#       #    #
#  ######    #
#            0
######## #####
       # #    
       ###    
